Where My Heart Belongs	Urovene Cove	Sob Evariste Dibo	Acromantis luzonica	Kota Kinabalu Convention City	Ben Chapman (actor)	Henry David	Sullivan Township, Moultrie County, Illinois	Lgota Błotna	Cairo International Book Fair	Matsuura Station	2010 African Championships in Athletics – Men's 3000 metres steeplechase	Medawi	St Mary's Church, Cheloor	Nery Kennedy	Savage Town, Virginia	Taylor Tharp	Lynne Barasch	Limido Comasco	USNS Henson (T-AGS-63)	Papineauville, Quebec	Gaussian Curve (band)	Tom Hovasse	Dmytro Pavlychko	Huawei Nova 3i	Travis Fimmel	Federigo Luigi Appelius	Sandy White (footballer)	Kosmos 165	Giving and Taking	Youssef Makkar	DZRD	Association of Amalgamated Territorial Communities	Brian Falkner	1932 World Table Tennis Championships – Men's singles	Andreína Llamozas	Whittni Wright	Jabal Umm al Ru'us	Bianca Scacciati	Instituto San Andrés	Paris police headquarters stabbing	Helen Haiman Joseph	Atomic Age	Adam Rowntree	znanost.org	La Couronne, Bouches-du-Rhône	Great helm	ApexKB	Catholic campus ministry	Senriyama Station	Touch of Class (horse)	Eleanor Tiernan	YouTube Shorts	Petr Míka	Black Fantasy	Talk to Me (Tory Lanez and Rich the Kid song)	1992 Louisville Cardinals football team	Pasquale Cati	19th Kansas Volunteers	Sun Country Airlines	Eddie Campagnuolo	Santutxu FC	Collared warbling finch	Jacqueline Krim	Hermodice carunculata	UltraMantis Black	Believo!	Museum of British Surfing	Museum of Russian Art	Vista Grande High School	Nataly Andria	Carlos Lima	Eduard Oja	Harry Nadjarian	Blowing the Whistle	Survey of Ophthalmology	Eyüp Can (journalist)	Mindoro Wind Farm	Robin Donovan	Nick O'Hern	Marko Trojak	Gerald Koh	Division No. 7, Subdivision K, Newfoundland and Labrador	Beth David Synagogue (Amenia, New York)	NPO ELSIB	Dillon Gordon	Danger in the Pacific	Murder of Graham McKenna	Studzieniec, Oborniki County	Tramp! Tramp! Tramp!	Karima Abd-Daif	Enyne	Northern Lights: A Journey to Love	GameStorm (convention)	Menifee County, Kentucky	Puerto Rico Highway 38	Gordon Connell (rugby union)	Roland Dorcely	Gabriella Cuevas	USS LCT-242	
Naachtun	Thomas Summers West	Begli Nurmyradow	Torje Naustdal	List of NJCAA Division I schools	Hales	2018 WTA Finals – Singles	McCaskie	Diving at the 2015 Summer Universiade – Women's 10 metre platform	Johann Christian Martin Bartels	Tribal Warrior	Cosmic Coaster (Worlds of Fun)	2011 ATP Challenger Trophy – Doubles	SC6 (TV program)	Nenagh Ormond	Françoise Nyssen	Edinburgh Courant	Alexandra Vandernoot	Drysdale gudgeon	Lobocheilos rhabdoura	2009 Humanitarian Bowl	Coleotechnites colubrinae	Miss Israel 1977	List of legal entity types by country	Alzoniella slovenica	Éljúðnir	Bay whiting	CD La Granja	Raid on Sodus	Taylor's Ford Bridge	Dragutin Gostuški	Spellevator	2018 UCI Track Cycling World Championships	Pomacea falconensis	Henricus Jacobus Tollens	Palacio de Aldama	List of Muay Thai practitioners	After Laughter Tour	Norman Jordaan	Buneh Rizak-e Chenar	Calliotropis hataii	List of New York Red Bulls seasons	Courtland Township, Nicollet County, Minnesota	Sukanta College	National Aeronautic Association	Maclocks	Crosswinds (Capercaillie album)	Chocolate (EP)	2017 Australian Open – Wheelchair quad doubles	Promise Neighborhoods	
Aya Ben Abdallah	Battle of Maranga	Antti Lehtonen	Jim Hankinson	Bernadine	Gran Teatro Nacional (Mexico)	Charles L. Carson	Jala Brat	Jean-Marc Moret	Gottfried Lengnich	1973 Portuguese Guinea Legislative Assembly election	Nemo Bahari	Filip Blašković	John Bolton (illustrator)	Randy Terbush	Battle of Pookkottur	Gotta Get Up	Maynard (broadcaster)	Shamrock organization	Thomas A. Cullinan	Ato Kwamina Yanney Snr.	Samuel Robert Lichter	Flagellation	George Stobbart (footballer)	Klaus Waris	Nemenikuće	Mark Pinkosh	Nam Định station	William Plumer (1736–1822)	Hynobius naevius	Cerconota tinctipennis	S.A. Kimbrough House	William Bassett (d. 1667)	Gevorg Sargsyan	Mei Wahs	Sno-Core Compilation	Niemandsland and Beyond	Hebe (1791 ship)	MTRNR2L6	National Counties Cricket Championship	Paul Masson (cyclist)	Magento	List of Doug characters	Kalamazoo Jr. K-Wings	1905–06 MIT Engineers men's ice hockey season	Robert Oatey	Roser Bastida Areny	Nanmendou station	David C. Evans	2014 Valencian Community motorcycle Grand Prix	
John Hetherton	Srđan Mijailović	Sleeping Dogs (TV series)	
Jugazan	UEFA Women's Euro 2001 squads	Caseyidae	
2020 IIHF World Championship Division III	KrasAvia	Acer pictum subsp. mono	
Bulk messaging	Eomysticetidae	Diving at the 2014 European Aquatics Championships – Men's 3 m springboard	
Oregocerata cladognathos	Arkansas Highway 341	Janez Pleteršek	
Joe Schmidt (American football)	Ingvar Kärnefelt	Priacanthiformes	
Pulmonary bay	Mitromorpha grammatula	1867 Belmont Stakes	
Dirk Albert Hooijer	Burtonport railway station	2003 Grand Prix Hassan II – Singles	
Hesar-e Yazdan	Pembroke Land District	Emilia di Liverpool	
1908 Michigan Agricultural Aggies football team	Strawberry pie	Neklinovsky District	
Platinum pentafluoride	Jonathan Spottiswoode	Thiel-sur-Acolin	
Mollebamba District	Erika González	Ostrykół Dworski	
Hiré	Fools for Scandal	Mayfield railway station	
Grand Comoro brush warbler	Cabanatuan longganisa	Emmanuel Savary	
Public housing estates in Wong Tai Sin	Speed Farm	Fateh Ziadi	
Monastero delle Murate	2007 All Golds Tour	Agyneta chiricahua	
2008–09 FFHG Division 1 season	Lake Gibson (Ontario)	Ivan Yevreinov	
Svetlana Chernishova	John Twist	Yelisavetgradsky Uyezd	
John Charlton Fisher	1964–65 Stoke City F.C. season	Erika Liebman	
Titanic Express massacre	Robert Samuel	Deep-water coral	
The Fountain House (Doylestown, Pennsylvania)	Achille Collas	Clara Gold	
Zagustay	Heritage High School (Romoland, California)	Flemming Muus	
Indigenous planning	Idi language	Austin Film Critics Association Award for Best Ensemble	
Maria Tenazi	Paul Oziol de Pignol	1994 Cannes Film Festival	
Bredwardine	A75 road	Stellated octahedron	Mafruzlu, Azerbaijan	2014 Roger Federer tennis season	Abound Solar	Virgil Livers	Tyutyunche	Timeline of Tokyo	Pope Clement V	Bevo Francis Award	James Bryant (South African cricketer)	Christian Wieczorek	Middle East Television	Morison equation	Rosemary Thomas (diplomat)	Miguel Marqués (composer)	1994 Austrian legislative election	Battle of Drewry's Bluff	Busan station	William Greynton	East Downtown Houston	1982–83 UCLA Bruins men's basketball team	Elliptic gamma function	Mary Cromwell Jarrett	Cristian Báez	Ol' Dirty Bastard	Grasshopper Scouts	Wendy Cracked a Walnut: Original Soundtrack Recording	Geoff Crudgington	
Capay Valley	Vaskiluoto railway station	Finnmarkshallen	British Library, Add MS 17122	Borneman	Geneille Greaves	1994 San Jose Open – Singles	Rennerod	Faveoloolithus	Sammie Abbott	Jesse Scoble	Agamemnon Channel	Interactive Investor	Mount Cook (Magnetic Island)	Kokoro no Wakusei (Little Planets)	Pond heron	Electrochemiluminescence	Slimy sculpin	Solibacillus kalamii	Pat Pat Sat Sat Nhyoe	Jüri Liim	Norman Rae	Mahua Dabra Haripura	Aviamilano A2	List of airports in Shanghai	Robert Eversz	Distributive writing	Laguna de las Momias	Norman A. Erbe	Alfred (1818 ship)	
Gavin Fink	Barr Smith Library	Budy Stawiskie	Straw maze	Iehiro	Jennifer Montagu	Cultural retention	Nielsen's theorem	Marytown, West Virginia	Arryx	Ernst Flentje House	Woonasquatucket River	Local Government ICT Network	Kim Ng	Tomasz Motyka (footballer)	William Ditto	British Guiana 1c magenta	Berclair, Mississippi	Sędziszów Małopolski	Ian Tapp	Elim Pavlovich Demidov, 3rd Prince of San Donato	Icabod Bradley House	Strathnairn Homestead, Australian Capital Territory	Godfroy Langlois	List of former state routes in Georgia (U.S. state, 700–1109)	Lambdin	Olav Bjørnstad	Vues d'Afrique	Louis Lichtenfield	Karachi Port Trust cricket team	
Gelechia nervosella	Guamia	Pectoral sparrow	
Tnine Aglou	Gad Navon	Survant, Indiana	
Rybno, Sochaczew County	Mill Creek (West Canada Creek tributary)	Baranovo, Velikoustyugsky District, Vologda Oblast	
Harborough District Council elections	Literary Kicks	Sangster International Airport	
Frank J. Magill	Battle of Chevilly	Hofmannophila	
Broad Street – Davis Park Historic District	Paolo Dal Fiume	Ngwa	
Elisabeth Rynell	Dylan O'Grady	Busabos ng Palad	
Gavin Mahon	Football Manager 2017	Loliolus japonica	
Bulls and Cows	Komarovka, Samara Oblast	May East	
Baranavichy Voblast	John Fleck (actor)	Cavalry Stetson	
Milan Stojanoski	Tajique, New Mexico	Oakdale High School (California)	
GASUN	2008 German Grand Prix	Bradley Kamdem	
Patricia A. McKillip bibliography	Frain, Vosges	Gush Katif	
Shooting of Abdullahi Omar Mohamed	Ramaipur	1949 Saint Mary's Gaels football team	
Javed Akhtar Khan Lund	Hipparion	Oakham United F.C. (Rutland)	
Long Island Farm	Victoria Road drill hall	Slavko Aleksić	
Sir Harold Hillier Gardens	Luana Patten	Black and White and Dead All Over	
Jan van Loggerenberg	Park Soon-kyung	Kevin Hand	
1930 Nebraska gubernatorial election	Timo von Gunten	Diania	
Kachorwa	W43BR	Tonb-e Jaki	
Baker Ministry	Shane Firus	Chic (horse)	
Engenho Novo Station	Plesk	Civil Air Transport	
List of fencers	Oncotylus punctiger	Gaurotes striatopunctata	
Vernon Treatt	Not That Far Away (EP)	Gonialoe	
Dzerzhinsky Political-Military Academy in Warsaw	Adjutant-General (India)	Government Junta of Chile (1925)	
Shuragat	Rick Mount	Peter Snowe	
Culture of North Carolina	Kyaw Tin	Starshine Records	
Inangahua Junction	Border Troops of the State Security Service (Uzbekistan)	Epitamyra albomaculalis	
Almond milk	Movement for All-Macedonian Action	Maria Sonia Cristoff	
Secret Harbour, Western Australia	Ricky (2009 film)	Jan Cremers	
Neatus	Olaus Arvesen	Political Warfare Bureau	
Tetteh Quarshie	Cristoforo Coriolano	Down Junior Football Championship	
1983 Uruguayan Primera División	Francesco Gerbaldi	Bahadurgarh City metro station	
Edmonton Group	Hassan Shahsavan	Myrsini Malakou	
Chantada stabbing	Redcliff Battery	C. Desmond Greaves	
Hed Church	Sezen	Fred Baron (footballer)	
Crow (comics)	Blond Eckbert	Timeline of British history (1990–present)	
Anoncia sphacelina	Leck Air Base	Railway reconstruction in Taiwan	
Angus Tait	Bishop's Landing Airport	Bhaskargad	
Open Season (Feist album)	Grace Daniel	Akatov	
Hanson Boakai	2007–08 South China AA season	Stefan Vukmirović	
Dance Band	Kharkiv-style bandura	National Justice Movement	
Ulrike Mathesius	Thallarcha fusa	Green Lake Falls	
Platymantis paengi	Koehler Township, Michigan	Jefferson in Paris	
Gaveh, Khusf	Independent Arakanese Parliamentary Group	Décollement	
Miroszów	1980–81 Golden State Warriors season	Väinölänniemi	
Flag of the Republic of China	The Cambridge History of Inner Asia	Los Angeles Lazers	
Tulsipur Assembly constituency	Johannes Dantiscus	Quebec Bulldogs	
Boris Neveu	List of United States Supreme Court cases, volume 95	Jim Rutherford (rugby league)	
Luigi Luxardo	Côr Meibion Pontypridd	Andrija Zlatić	
Derio station	Moscow Finnish School	Jaltomata aspera	
Última Hora (Paraguay)	Daegok station (Daegu Metro)	Carrier selection codes in Chile	
Nightingale (Erland and the Carnival album)	2014–15 South Carolina State Bulldogs basketball team	Ballhausplatz	
Supreme Snowboarding	List of Philippine place names of Spanish origin	Escape Me Never (1935 film)	
Roman Lyashenko	Mäeküla, Paide Parish	Chiddushei Rabbeinu Chaim	
Henrey	League Park	Aviis Zhong	
Bo'ness F.C.	List of Northwestern State Demons football seasons	Palavansathu	
